type,measure,beat,beatCount,text
0,1,1,4,-
0,1,3,4,-
0,1,5,4,-
0,1,7,4,-
0,2,1,4,-
0,2,3,4,-
0,2,5,4,-
0,2,7,4,-
0,3,1,4,-
0,3,3,4,-
0,3,5,4,-
0,3,7,4,-
0,4,1,4,-
0,4,3,4,-
0,4,5,4,-
0,4,7,4,-
1,5,2,4,-
1,5,4,4,-
1,5,6,4,-
1,5,8,4,-
1,6,2,4,-
1,6,4,4,-
1,6,6,4,-
1,6,8,4,-
1,7,2,4,-
1,7,4,4,-
1,7,6,4,-
1,7,8,4,-
1,8,2,4,-
1,8,4,4,-
1,8,6,4,-
1,8,8,4,-